###############
#.#.......#.#S#
#.###.#####.#.#
#...#.#.....#.#
###.#.#.#####.#
#.#.#.#.....#.#
#.#.#.#.#####.#
#.#.....#.#...#
#.#.###.#.#.#.#
#...#.......#.#
#.#.###.#####.#
#.#.......#...#
#.#####.#.#####
#E#.....#.....#
###############
