###############
#.....#...#.#S#
###.#.###.#.#.#
#.....#.......#
#.#.#.#.#######
#.#...#...#...#
#.#.#.#.###.#.#
#.......#.#...#
#####.#.#.#.###
#.#.#.....#...#
#.#.#.#.#.#.#.#
#E....#.......#
###############
